ABANDON	AH.B.AE.N.D.AH.N
ABERRANT	AE.B.EH.R.AH.N.T
ABORTIVE	AH.B.AO.R.T.IH.V
ABOUND	AH.B.AW.N.D
ABSTRACT	AE.B.S.T.R.AE.K.T
ABUSE	AH.B.Y.UW.Z
ACCEDE	AE.K.S.IY.D
ACCORD	AH.K.AO.R.D
ACHIEVE	AH.CH.IY.V
ACRE	EY.K.ER
ADDITION	AH.D.IH.SH.AH.N
ADJACENT	AH.JH.EY.S.AH.N.T
ADO	AH.D.UW
ADVERBIAL	AE.D.V.ER.B.IY.AH.L
AEROBIC	EH.R.OW.B.IH.K
AFFILIATE	AH.F.IH.L.IY.EY.T
AGITATION	AE.JH.AH.T.EY.SH.AH.N
AIRFRAME	EH.R.F.R.EY.M
ALARMIST	AH.L.AA.R.M.IH.S.T
ALCOHOL	AE.L.K.AH.HH.AA.L
ALGORITHM	AE.L.G.ER.IH.DH.AH.M
ALLEGRO	AH.L.EH.G.R.OW
ALLOTMENT	AH.L.AA.T.M.AH.N.T
ALLOY	AE.L.OY
ALLUSION	AH.L.UW.ZH.AH.N
ALLY	AH.L.AY
ALMOND	AA.M.AH.N.D
ALONG	AH.L.AO.NG
AMATEUR	AE.M.AH.T.ER
AMAZON	AE.M.AH.Z.AA.N
AMID	AH.M.IH.D
AMINO	AH.M.IY.N.OW
AMORIST	AE.M.ER.AH.S.T
AMPLITUDE	AE.M.P.L.AH.T.UW.D
AMUSE	AH.M.Y.UW.Z
AMUSING	AH.M.Y.UW.Z.IH.NG
ANALYTIC	AE.N.AH.L.IH.T.IH.K
ANCESTRY	AE.N.S.EH.S.T.R.IY
ANCHOR	AE.NG.K.ER
ANECDOTE	AE.N.AH.K.D.OW.T
ANNOY	AH.N.OY
ANVIL	AE.N.V.AH.L
ANXIOUS	AE.NG.SH.AH.S
ANYTHING	EH.N.IY.TH.IH.NG
APOSTLE	AH.P.AA.S.AH.L
ARBITRATE	AA.R.B.AH.T.R.EY.T
ARROYO	ER.OY.OW
ASCENT	AH.S.EH.N.T
ASININE	AE.S.AH.N.AY.N
ASSAIL	AH.S.EY.L
ASSISTANT	AH.S.IH.S.T.AH.N.T
ATLAS	AE.T.L.AH.S
ATMOSPHERE	AE.T.M.AH.S.F.IH.R
ATOP	AH.T.AA.P
ATTRIBUTE	AH.T.R.IH.B.Y.UW.T
ATTRITION	AH.T.R.IH.SH.AH.N
AUDIO	AA.D.IY.OW
AUSPICE	AO.S.P.IH.S
AUTONOMY	AO.T.AA.N.AH.M.IY
AVOID	AH.V.OY.D
AW	AO
AWKWARD	AO.K.W.ER.D
AYE	AY
AZALEA	AH.Z.EY.L.Y.AH
BACKLASH	B.AE.K.L.AE.SH
BACKWOODS	B.AE.K.W.UH.D.Z
BALLET	B.AE.L.EY
BALMY	B.AA.M.IY
BARGAIN	B.AA.R.G.IH.N
BARITONE	B.EH.R.AH.T.OW.N
BASEMENT	B.EY.S.M.AH.N.T
BASHFUL	B.AE.SH.F.AH.L
BASTARD	B.AE.S.T.ER.D
BATTER	B.AE.T.ER
BAZAAR	B.AH.Z.AA.R
BEAN	B.IY.N
BED	B.EH.D
BEGIN	B.IH.G.IH.N
BELOVED	B.IH.L.AH.V.D
BELTING	B.EH.L.T.IH.NG
BEREFT	B.ER.EH.F.T
BESIEGE	B.IH.S.IY.JH
BEVY	B.EH.V.IY
BIG	B.IH.G
BLACKMAIL	B.L.AE.K.M.EY.L
BLACKOUT	B.L.AE.K.AW.T
BLANDLY	B.L.AE.N.D.L.IY
BLOCK	B.L.AA.K
BLOCKHOUSE	B.L.AA.K.HH.AW.S
BLUR	B.L.ER
BOARDING	B.AO.R.D.IH.NG
BOISTEROUS	B.OY.S.T.R.AH.S
BOLSTER	B.OW.L.S.T.ER
BOMBER	B.AA.M.ER
BOOGIE	B.UW.G.IY
BOOKSHELF	B.UH.K.SH.EH.L.F
BOORISH	B.UH.R.IH.SH
BOUNDLESS	B.AW.N.D.L.AH.S
BOWEL	B.AW.AH.L
BOY	B.OY
BOYCOTT	B.OY.K.AA.T
BRAVADO	B.R.AH.V.AA.D.OW
BREAKTHROUGH	B.R.EY.K.TH.R.UW
BREATHING	B.R.IY.DH.IH.NG
BREW	B.R.UW
BRIDE	B.R.AY.D
BRILLIANCE	B.R.IH.L.Y.AH.N.S
BROACH	B.R.OW.CH
BROIL	B.R.OY.L
BRUISE	B.R.UW.Z
BRUSH	B.R.AH.SH
BRUTAL	B.R.UW.T.AH.L
BUCKSKIN	B.AH.K.S.K.IH.N
BUILD	B.IH.L.D
BUILDER	B.IH.L.D.ER
BULK	B.AH.L.K
BULKHEAD	B.AH.L.K.HH.EH.D
BULLSHIT	B.UH.L.SH.IH.T
BUM	B.AH.M
BUNDLE	B.AH.N.D.AH.L
BUNT	B.AH.N.T
BUREAU	B.Y.UH.R.OW
BURROW	B.ER.OW
BUT	B.AH.T
BUTCHER	B.UH.CH.ER
BUTTRESS	B.AH.T.R.AH.S
BYGONE	B.AY.G.AO.N
CALLING	K.AO.L.IH.NG
CANAL	K.AH.N.AE.L
CANON	K.AE.N.AH.N
CANVASS	K.AE.N.V.AH.S
CAPITOL	K.AE.P.IH.T.AH.L
CAPRICIOUS	K.AH.P.R.IH.SH.AH.S
CAPTURE	K.AE.P.CH.ER
CAREER	K.ER.IH.R
CARICATURE	K.EH.R.AH.K.AH.CH.ER
CARP	K.AA.R.P
CASINO	K.AH.S.IY.N.OW
CEASELESSLY	S.IY.Z.L.AH.S.L.IY
CHANCERY	CH.AE.N.S.ER.IY
CHAOS	K.EY.AA.S
CHART	CH.AA.R.T
CHEEK	CH.IY.K
CHEERY	CH.IH.R.IY
CHILI	CH.IH.L.IY
CHOLERA	K.AA.L.ER.AH
CHOPPER	CH.AA.P.ER
CHUNK	CH.AH.NG.K
CLAW	K.L.AO
CLEAVE	K.L.IY.V
CLIMAX	K.L.AY.M.AE.K.S
CLINCHER	K.L.IH.N.CH.ER
CLOCKWORK	K.L.AA.K.W.ER.K
CLOTHES	K.L.OW.Z
CLOTHING	K.L.OW.DH.IH.NG
CLOUD	K.L.AW.D
CLOUDY	K.L.AW.D.IY
CLOY	K.L.OY
CLUCK	K.L.AH.K
COACH	K.OW.CH
COCAINE	K.OW.K.EY.N
COCKEYED	K.AA.K.AY.D
COCO	K.OW.K.OW
CODE	K.OW.D
COED	K.OW.EH.D
COEXIST	K.OW.AH.G.Z.IH.S.T
COGNAC	K.OW.N.Y.AE.K
COHESION	K.OW.HH.IY.ZH.AH.N
COLLAGEN	K.AA.L.AH.G.AH.N
COLLECTIVE	K.AH.L.EH.K.T.IH.V
COLONY	K.AA.L.AH.N.IY
COMA	K.OW.M.AH
COMB	K.OW.M
COMMENT	K.AA.M.EH.N.T
COMMITTEE	K.AH.M.IH.T.IY
COMMUNAL	K.AH.M.Y.UW.N.AH.L
COMPETE	K.AH.M.P.IY.T
COMPLAINT	K.AH.M.P.L.EY.N.T
COMPLETE	K.AH.M.P.L.IY.T
COMPORT	K.AH.M.P.AO.R.T
CONDUCIVE	K.AH.N.D.UW.S.IH.V
CONFEREE	K.AA.N.F.ER.IY
CONNIVANCE	K.AH.N.AY.V.AH.N.S
CONSOLE	K.AH.N.S.OW.L
CONTAIN	K.AH.N.T.EY.N
CONVOY	K.AA.N.V.OY
COOK	K.UH.K
COPYWRITER	K.AA.P.IY.R.AY.T.ER
CORNER	K.AO.R.N.ER
CORNMEAL	K.AO.R.N.M.IY.L
CORNY	K.AO.R.N.IY
CORTEGE	K.AO.R.T.EH.ZH
COUNTER	K.AW.N.T.ER
COUNTERACT	K.AW.N.T.ER.AE.K.T
CRAFT	K.R.AE.F.T
CRAGGY	K.R.AE.G.IY
CRAMP	K.R.AE.M.P
CRAZY	K.R.EY.Z.IY
CREATION	K.R.IY.EY.SH.AH.N
CREVICE	K.R.EH.V.AH.S
CRIMSON	K.R.IH.M.Z.AH.N
CROOK	K.R.UH.K
CULTURE	K.AH.L.CH.ER
CURIOUS	K.Y.UH.R.IY.AH.S
CURLY	K.ER.L.IY
CUTTER	K.AH.T.ER
CYLINDER	S.IH.L.IH.N.D.ER
DANCE	D.AE.N.S
DANK	D.AE.NG.K
DEAD	D.EH.D
DEALER	D.IY.L.ER
DEBT	D.EH.T
DEBUT	D.EY.B.Y.UW
DECREASE	D.IY.K.R.IY.S
DEEPLY	D.IY.P.L.IY
DELEGATE	D.EH.L.AH.G.EY.T
DEMAND	D.IH.M.AE.N.D
DEMANDING	D.IH.M.AE.N.D.IH.NG
DERELICT	D.EH.R.AH.L.IH.K.T
DERISION	D.ER.IH.ZH.AH.N
DERIVATIVE	D.ER.IH.V.IH.T.IH.V
DESECRATE	D.EH.Z.AH.K.R.EY.T
DESERVING	D.IH.Z.ER.V.IH.NG
DESPOT	D.EH.S.P.AH.T
DETECTION	D.IH.T.EH.K.SH.AH.N
DIALYSIS	D.AY.AE.L.IH.S.IH.S
DIATHERMY	D.AY.AH.TH.ER.M.IY
DIATOMIC	D.AY.AH.T.AA.M.IH.K
DIE	D.AY
DIFFUSE	D.IH.F.Y.UW.Z
DIG	D.IH.G
DIGNITY	D.IH.G.N.AH.T.IY
DILIGENCE	D.IH.L.IH.JH.AH.N.S
DIMINISH	D.IH.M.IH.N.IH.SH
DINE	D.AY.N
DIRECTLY	D.IY.R.EH.K.L.IY
DISABLE	D.IH.S.EY.B.AH.L
DISCLOSURE	D.IH.S.K.L.OW.ZH.ER
DISENGAGE	D.IH.S.IH.N.G.EY.JH
DISLODGE	D.IH.S.L.AA.JH
DISMAL	D.IH.Z.M.AH.L
DISOWN	D.IH.S.OW.N
DISPLAY	D.IH.S.P.L.EY
DISSENTER	D.IH.S.EH.N.T.ER
DISSOLVE	D.IH.Z.AA.L.V
DISTURBING	D.IH.S.T.ER.B.IH.NG
DITCH	D.IH.CH
DIVULGE	D.IH.V.AH.L.JH
DOG	D.AO.G
DOGGONE	D.AO.G.AO.N
DOMAIN	D.OW.M.EY.N
DON	D.AA.N
DOOMSDAY	D.UW.M.Z.D.EY
DOWN	D.AW.N
DOWNHILL	D.AW.N.HH.IH.L
DOWNWARD	D.AW.N.W.ER.D
DRAFT	D.R.AE.F.T
DRIVER	D.R.AY.V.ER
DROVER	D.R.OW.V.ER
DRUDGERY	D.R.AH.JH.ER.IY
DRUG	D.R.AH.G
DUD	D.AH.D
DUEL	D.UW.AH.L
DUST	D.AH.S.T
EASIER	IY.Z.IY.ER
EASY	IY.Z.IY
EATABLE	IY.T.AH.B.AH.L
EFFACE	IH.F.EY.S
EFFORTLESS	EH.F.ER.T.L.AH.S
ELEVENTH	IY.L.EH.V.AH.N.TH
ELONGATE	IH.L.AO.NG.G.EY.T
ELSE	EH.L.S
ENCHANT	EH.N.CH.AE.N.T
ENDEAVOR	IH.N.D.EH.V.ER
ENJOYMENT	IH.N.JH.OY.M.AH.N.T
ENSEMBLE	AA.N.S.AA.M.B.AH.L
ENTITLE	IH.N.T.AY.T.AH.L
ENTOURAGE	AA.N.T.UH.R.AA.ZH
ENTROPY	EH.N.T.R.AH.P.IY
ENTRUST	EH.N.T.R.AH.S.T
ENTWINE	EH.N.T.W.AY.N
ENUMERATE	IH.N.UW.M.ER.EY.T
ENVISION	EH.N.V.IH.ZH.AH.N
EQUATION	IH.K.W.EY.ZH.AH.N
ERECT	IH.R.EH.K.T
ERROR	EH.R.ER
ESSENTIAL	IY.S.EH.N.SH.AH.L
ETHICALLY	EH.TH.IH.K.AH.L.IY
EUPHORIA	Y.UW.F.AO.R.IY.AH
EVENING	IY.V.N.IH.NG
EVERGREEN	EH.V.ER.G.R.IY.N
EXAGGERATE	IH.G.Z.AE.JH.ER.EY.T
EXCEED	IH.K.S.IY.D
EXCESS	IH.K.S.EH.S
EXECUTE	EH.K.S.AH.K.Y.UW.T
EXHIBITOR	IH.G.Z.IH.B.AH.T.ER
EXPAND	IH.K.S.P.AE.N.D
EXPLOIT	EH.K.S.P.L.OY.T
EXPOSURE	IH.K.S.P.OW.ZH.ER
EYEBALL	AY.B.AO.L
EYESIGHT	AY.S.AY.T
FACTION	F.AE.K.SH.AH.N
FAILURE	F.EY.L.Y.ER
FALLACY	F.AE.L.AH.S.IY
FALSEHOOD	F.AE.L.S.HH.UH.D
FAMED	F.EY.M.D
FANCY	F.AE.N.S.IY
FAREWELL	F.EH.R.W.EH.L
FAST	F.AE.S.T
FATHOM	F.AE.DH.AH.M
FAVOR	F.EY.V.ER
FEATHER	F.EH.DH.ER
FEEL	F.IY.L
FEMININE	F.EH.M.AH.N.AH.N
FEN	F.EH.N
FENUGREEK	F.EH.N.UW.G.R.IY.K
FERTILE	F.ER.T.AH.L
FETE	F.EY.T
FIELD	F.IY.L.D
FIGURINE	F.IH.G.Y.ER.IY.N
FILTER	F.IH.L.T.ER
FINANCE	F.IH.N.AE.N.S
FINANCIER	F.IH.N.AH.N.S.IH.R
FINDING	F.AY.N.D.IH.NG
FIRE	F.AY.R
FIRECRACKER	F.AY.ER.K.R.AE.K.ER
FIREPLACE	F.AY.ER.P.L.EY.S
FIRM	F.ER.M
FIT	F.IH.T
FITFUL	F.IH.T.F.AH.L
FIVE	F.AY.V
FIXTURE	F.IH.K.S.CH.ER
FJORD	F.Y.AO.R.D
FLANNEL	F.L.AE.N.AH.L
FLAVORING	F.L.EY.V.ER.IH.NG
FLECK	F.L.EH.K
FLOWERING	F.L.AW.ER.IH.NG
FLUORIDE	F.L.UH.R.AY.D
FLURRY	F.L.ER.IY
FLUSH	F.L.AH.SH
FOLD	F.OW.L.D
FOLDER	F.OW.L.D.ER
FOOTBALL	F.UH.T.B.AO.L
FOOTNOTE	F.UH.T.N.OW.T
FOOTSTEP	F.UH.T.S.T.EH.P
FOR	F.R.ER
FOREHEAD	F.AO.R.HH.EH.D
FORESIGHT	F.AO.R.S.AY.T
FORMAL	F.AO.R.M.AH.L
FORMER	F.AO.R.M.ER
FORT	F.AO.R.T
FOUNDER	F.AW.N.D.ER
FOUR	F.AO.R
FRACTURE	F.R.AE.K.SH.ER
FRAIL	F.R.EY.L
FRANKNESS	F.R.AE.NG.K.N.AH.S
FRAY	F.R.EY
FREQUENT	F.R.IY.K.W.EH.N.T
FRESCO	F.R.EH.S.K.OW
FRICTION	F.R.IH.K.SH.AH.N
FROLIC	F.R.AA.L.IH.K
FROSTBITE	F.R.AO.S.T.B.AY.T
FULL	F.UH.L
FUME	F.Y.UW.M
FUNGICIDE	F.AH.N.JH.AH.S.AY.D
FUNNY	F.AH.N.IY
FURLOUGH	F.ER.L.OW
FUTURE	F.Y.UW.CH.ER
GALLSTONE	G.AO.L.S.T.OW.N
GAUGE	G.EY.JH
GENE	JH.IY.N
GENERALLY	JH.EH.N.R.AH.L.IY
GENRE	ZH.AA.N.R.AH
GHOSTLY	G.OW.S.T.L.IY
GHOUL	G.UW.L
GIFTED	G.IH.F.T.IH.D
GLAMOROUS	G.L.AE.M.ER.AH.S
GLANCE	G.L.AE.N.S
GLIMPSE	G.L.IH.M.P.S
GLINT	G.L.IH.N.T
GLOSSARY	G.L.AO.S.ER.IY
GLOWER	G.L.AW.ER
GOB	G.AA.B
GOSSIP	G.AA.S.AH.P
GRAPPLING	G.R.AE.P.L.IH.NG
GREAT	G.R.EY.T
GREED	G.R.IY.D
GRIMACE	G.R.IH.M.AH.S
GRIN	G.R.IH.N
GROPING	G.R.OW.P.IH.NG
GRUDGE	G.R.AH.JH
GUIDE	G.AY.D
HAMMER	HH.AE.M.ER
HANDSOME	HH.AE.N.S.AH.M
HANDY	HH.AE.N.D.IY
HAPPILY	HH.AE.P.AH.L.IY
HAPPINESS	HH.AE.P.IY.N.AH.S
HARANGUE	HH.ER.AE.NG
HARDWARE	HH.AA.R.D.W.EH.R
HARDY	HH.AA.R.D.IY
HARPING	HH.AA.R.P.IH.NG
HAZE	HH.EY.Z
HEADDRESS	HH.EH.D.R.EH.S
HEADING	HH.EH.D.IH.NG
HEATHEN	HH.IY.DH.AH.N
HEAVY	HH.EH.V.IY
HELIUM	HH.IY.L.IY.AH.M
HELM	HH.EH.L.M
HEMORRHAGE	HH.EH.M.R.AH.JH
HERALD	HH.EH.R.AH.L.D
HEREBY	HH.IH.R.B.AY
HEROIN	HH.EH.R.OW.AH.N
HI	HH.AY
HIGHLY	HH.AY.L.IY
HIGHNESS	HH.AY.N.AH.S
HINDER	HH.IH.N.D.ER
HINGE	HH.IH.N.JH
HINT	HH.IH.N.T
HISSING	HH.IH.S.IH.NG
HISTORY	HH.IH.S.T.R.IY
HITHER	HH.IH.DH.ER
HITHERTO	HH.IH.DH.ER.T.UW
HOG	HH.AA.G
HOLD	HH.OW.L.D
HOLIDAY	HH.AA.L.IH.D.EY
HOLLOW	HH.AA.L.OW
HOMEBOUND	HH.OW.M.B.AW.N.D
HON	HH.AH.N
HONESTLY	AA.N.AH.S.T.L.IY
HONORABLE	AA.N.ER.AH.B.AH.L
HORRIBLE	HH.AO.R.AH.B.AH.L
HORSEFLESH	HH.AO.R.S.F.L.EH.SH
HOTHOUSE	HH.AA.T.HH.AW.S
HOUSEKEEPING	HH.AW.S.K.IY.P.IH.NG
HUCKSTER	HH.AH.K.S.T.ER
HUMAN	Y.UW.M.AH.N
HUMANELY	HH.Y.UW.M.EY.N.L.IY
HUMANIZE	HH.Y.UW.M.AH.N.AY.Z
HUMP	HH.AH.M.P
HUNTING	HH.AH.N.T.IH.NG
ICICLE	AY.S.IH.K.AH.L
IDYLL	AY.D.AH.L
IMMENSE	IH.M.EH.N.S
IMMORTAL	IH.M.AO.R.T.AH.L
IMPACT	IH.M.P.AE.K.T
IN	IH.N
INBOARD	IH.N.B.AO.R.D
INCENTIVE	IH.N.S.EH.N.T.IH.V
INCIDENT	IH.N.S.AH.D.AH.N.T
INCULCATE	IH.NG.K.AH.L.K.EY.T
INDOLENT	IH.N.D.AH.L.AH.N.T
INFANTILE	IH.N.F.AH.N.T.IH.L
INFECTIOUS	IH.N.F.EH.K.SH.AH.S
INFER	IH.N.F.ER
INFIDEL	IH.N.F.IH.D.EH.L
INITIATE	IH.N.IH.SH.IY.EY.T
INKLING	IH.NG.K.L.IH.NG
INNING	IH.N.IH.NG
INOPPORTUNE	IH.N.AA.P.ER.T.UW.N
INSIDE	IH.N.S.AY.D
INSPECTOR	IH.N.S.P.EH.K.T.ER
INSURGENT	IH.N.S.ER.JH.AH.N.T
INTER	IH.N.T.ER
INTERCHANGE	IH.N.T.ER.CH.EY.N.JH
INTEREST	IH.N.T.R.IH.S.T
INTERFACE	IH.N.T.ER.F.EY.S
INTERFERE	IH.N.T.ER.F.IH.R
INTERIM	IH.N.T.R.AH.M
INTERLOCK	IH.N.T.ER.L.AA.K
INTERPOLATE	IH.T.ER.P.AH.L.EY.T
INTERPOSE	IH.N.T.ER.P.OW.Z
INTREPID	IH.N.T.R.EH.P.AH.D
INTRUSION	IH.N.T.R.UW.ZH.AH.N
INVADE	IH.N.V.EY.D
INWARDLY	IH.N.W.ER.D.L.IY
IOTA	AY.OW.T.AH
IRRATIONAL	IH.R.AE.SH.AH.N.AH.L
ITEMIZE	AY.T.AH.M.AY.Z
JAWBONE	JH.AO.B.OW.N
JERSEY	JH.ER.Z.IY
JIFFY	JH.IH.F.IY
JOCKEY	JH.AA.K.IY
JOINT	JH.OY.N.T
JOINTLY	JH.OY.N.T.L.IY
JOSS	JH.AO.S
JOVIAL	JH.OW.V.IY.AH.L
JOWL	JH.AW.L
JOYOUS	JH.OY.AH.S
JUDGEMENT	JH.AH.JH.M.AH.N.T
JUGGLE	JH.AH.G.AH.L
JUNGLE	JH.AH.NG.G.AH.L
JUROR	JH.UH.R.ER
JUSTIFY	JH.AH.S.T.AH.F.AY
KILL	K.IH.L
KNOT	N.AA.T
KNOW	N.OW
KRAUT	K.R.AW.T
LABEL	L.EY.B.AH.L
LADDER	L.AE.D.ER
LANDSCAPE	L.AE.N.S.K.EY.P
LANKY	L.AE.NG.K.IY
LAUGH	L.AE.F
LAUREATE	L.AO.R.IY.AH.T
LAVA	L.AA.V.AH
LEAP	L.IY.P
LEAPFROG	L.IY.P.F.R.AO.G
LEGALITY	L.IY.G.AE.L.AH.T.IY
LEGALIZE	L.IY.G.AH.L.AY.Z
LEVER	L.IY.V.ER
LEVITY	L.EH.V.IH.T.IY
LEXICON	L.EH.K.S.IH.K.AA.N
LIBERATE	L.IH.B.ER.EY.T
LIBRETTO	L.IH.B.R.EH.T.OW
LICENSE	L.AY.S.AH.N.S
LIFT	L.IH.F.T
LIGHTING	L.AY.T.IH.NG
LINGUIST	L.IH.NG.G.W.IH.S.T
LITER	L.IY.T.ER
LITTER	L.IH.T.ER
LIVER	L.IH.V.ER
LOATH	L.OW.TH
LOCKUP	L.AA.K.AH.P
LONGING	L.AO.NG.IH.NG
LOOSEN	L.UW.S.AH.N
LOP	L.AA.P
LOT	L.AO.T
LULL	L.AH.L
LUMINARY	L.UW.M.AH.N.EH.R.IY
LUNATIC	L.UW.N.AH.T.IH.K
LUNCH	L.AH.N.CH
LUNGE	L.AH.N.JH
LURE	L.UH.R
LURID	L.UH.R.AH.D
LUSTFUL	L.AH.S.T.F.AH.L
LUXURIOUS	L.AH.G.ZH.ER.IY.AH.S
M	EH.M.TH.R.IY
MAGICAL	M.AE.JH.IH.K.AH.L
MAGNIFY	M.AE.G.N.AH.F.AY
MALIGN	M.AH.L.AY.N
MANDAMUS	M.AE.N.D.EY.M.AH.S
MANIFEST	M.AE.N.AH.F.EH.S.T
MANIFOLD	M.AE.N.IH.F.OW.L.D
MATURE	M.AH.T.Y.UH.R
MAXIM	M.AE.K.S.AH.M
MAYHEM	M.EY.HH.EH.M
MEAN	M.IY.N
MECHANIZE	M.EH.K.AH.N.AY.Z
MELODIOUS	M.AH.L.OW.D.IY.AH.S
MEMO	M.EH.M.OW
MENAGERIE	M.AH.N.AE.JH.ER.IY
MENDACIOUS	M.EH.N.D.EY.SH.AH.S
MIGHTILY	M.AY.T.AH.L.IY
MILITATE	M.IH.L.IH.T.EY.T
MILLENNIUM	M.AH.L.EH.N.IY.AH.M
MINUS	M.AY.N.AH.S
MIRACLE	M.IH.R.AH.K.AH.L
MISERY	M.IH.Z.ER.IY
MISQUOTE	M.IH.S.K.W.OW.T
MISSIONARY	M.IH.SH.AH.N.EH.R.IY
MISSIVE	M.IH.S.IH.V
MOCCASIN	M.AA.K.AH.S.IH.N
MODERATOR	M.AA.D.ER.EY.T.ER
MOLASSES	M.AH.L.AE.S.AH.Z
MOLD	M.OW.L.D
MONTH	M.AH.N.TH
MORBID	M.AO.R.B.AH.D
MORTAR	M.AO.R.T.ER
MOTHERHOOD	M.AH.DH.ER.HH.UH.D
MOTION	M.OW.SH.AH.N
MOTTO	M.AA.T.OW
MOUND	M.AW.N.D
MOUNT	M.AW.N.T
MOVE	M.UW.V
MUCK	M.AH.K
MULE	M.Y.UW.L
MUSEUM	M.Y.UW.Z.IY.AH.M
MUSHROOM	M.AH.SH.R.UW.M
MUSICIAN	M.Y.UW.Z.IH.SH.AH.N
MUZZLE	M.AH.Z.AH.L
MYRIAD	M.IH.R.IY.AH.D
MYSTIFY	M.IH.S.T.AH.F.AY
MYTH	M.IH.TH
NAIL	N.EY.L
NAMELESS	N.EY.M.L.AH.S
NAP	N.AE.P
NATIVE	N.EY.T.IH.V
NATURE	N.EY.CH.ER
NAUGHT	N.AO.T
NAUSEATE	N.AO.Z.IY.EY.T
NEITHER	N.IY.DH.ER
NET	N.EH.T
NEURAL	N.Y.UH.R.AH.L
NEUTRON	N.UW.T.R.AA.N
NEWLY	N.UW.L.IY
NINETIETH	N.AY.N.T.IY.IH.TH
NITRATE	N.AY.T.R.EY.T
NORTHER	N.AO.R.DH.ER
NOSTRIL	N.AA.S.T.R.IH.L
NUMBER	N.AH.M.B.ER
NUZZLE	N.AH.Z.AH.L
OBLITERATE	AH.B.L.IH.T.ER.EY.T
OBSCURE	AH.B.S.K.Y.UH.R
OBTAIN	AH.B.T.EY.N
OBTRUDE	AH.B.T.R.UW.D
OCCURRENCE	AH.K.ER.AH.N.S
OCTOPUS	AA.K.T.AH.P.UH.S
OFF	AO.F
OFFICER	AO.F.IH.S.ER
OGLE	OW.G.AH.L
OLEANDER	OW.L.IY.AE.N.D.ER
ONENESS	W.AH.N.N.AH.S
OPPOSITE	AA.P.Z.AH.T
ORDEAL	AO.R.D.IY.L
ORIGINATE	ER.IH.JH.AH.N.EY.T
ORNATE	AO.R.N.EY.T
ORPHAN	AO.R.F.AH.N
OTHERWISE	AH.DH.ER.W.AY.Z
OUTGROWTH	AW.T.G.R.OW.TH
OUTRAGEOUS	AW.T.R.EY.JH.AH.S
OVERALL	OW.V.ER.AO.L
OVERLAY	OW.V.ER.L.EY
OVERSIGHT	OW.V.ER.S.AY.T
OVERTHROW	OW.V.ER.TH.R.OW
OWNERSHIP	OW.N.ER.SH.IH.P
PAIR	P.EH.R
PALAZZO	P.AH.L.AA.Z.OW
PALETTE	P.AE.L.AH.T
PALLIATIVE	P.AE.L.IY.AH.T.IH.V
PANACEA	P.AE.N.AH.S.IY.AH
PANTOMIME	P.AE.N.T.AH.M.AY.M
PANTY	P.AE.N.T.IY
PAPER	P.EY.P.ER
PAR	P.AA.R
PARABLE	P.EH.R.AH.B.AH.L
PARALLEL	P.EH.R.AH.L.EH.L
PARALYZE	P.EH.R.AH.L.AY.Z
PARCHMENT	P.AA.R.CH.M.AH.N.T
PARLOR	P.AA.R.L.ER
PARSLEY	P.AA.R.S.L.IY
PARTING	P.AA.R.T.IH.NG
PASTIME	P.AE.S.T.AY.M
PATCHWORK	P.AE.CH.W.ER.K
PATRIOT	P.EY.T.R.IY.AH.T
PAUSE	P.AO.Z
PAVEMENT	P.EY.V.M.AH.N.T
PEDANTIC	P.AH.D.AE.N.T.IH.K
PEDESTAL	P.EH.D.AH.S.T.AH.L
PENMAN	P.EH.N.M.AH.N
PENTAGON	P.EH.N.T.IH.G.AA.N
PER	P.ER
PERCHANCE	P.ER.CH.AE.N.S
PEREMPTORY	P.ER.EH.M.P.T.ER.IY
PERIPHERAL	P.ER.IH.F.R.AH.L
PETAL	P.EH.T.AH.L
PHOSPHORUS	F.AA.S.F.ER.AH.S
PHRASING	F.R.EY.Z.IH.NG
PHYSICIST	F.IH.Z.IH.S.IH.S.T
PINTO	P.IH.N.T.OW
PIOUS	P.AY.AH.S
PISS	P.IH.S
PLAN	P.L.AE.N
PLASTER	P.L.AE.S.T.ER
PLASTIC	P.L.AE.S.T.IH.K
PLATOON	P.L.AH.T.UW.N
PLAY	P.L.EY
PLAYGROUND	P.L.EY.G.R.AW.N.D
PLEDGE	P.L.EH.JH
PLUM	P.L.AH.M
PLY	P.L.AY
POINTED	P.OY.N.T.IH.D
POLE	P.OW.L
POLIO	P.OW.L.IY.OW
POLISH	P.OW.L.IH.SH
POLITIC	P.AA.L.AH.T.IH.K
PONDEROUS	P.AA.N.D.ER.AH.S
POPULATE	P.AA.P.Y.AH.L.EY.T
PORCELAIN	P.AO.R.S.AH.L.AH.N
POSITION	P.AH.Z.IH.SH.AH.N
POSITIVE	P.AA.Z.AH.T.IH.V
POSTPONE	P.OW.S.T.P.OW.N
POSTWAR	P.OW.S.T.W.AO.R
POTENTIAL	P.AH.T.EH.N.SH.AH.L
POTPOURRI	P.OW.P.UH.R.IY
PRAY	P.R.EY
PREACHER	P.R.IY.CH.ER
PREARRANGE	P.R.IY.ER.EY.N.JH
PRESS	P.R.EH.S
PRETEND	P.R.IY.T.EH.N.D
PREVIOUS	P.R.IY.V.IY.AH.S
PRIESTLY	P.R.IY.S.T.L.IY
PRIMARY	P.R.AY.M.EH.R.IY
PRIVACY	P.R.AY.V.AH.S.IY
PRO	P.R.OW
PROCEEDING	P.R.OW.S.IY.D.IH.NG
PRODUCT	P.R.AA.D.AH.K.T
PROFILE	P.R.OW.F.AY.L
PROGENY	P.R.AA.JH.AH.N.IY
PROGRESS	P.R.OW.G.R.EH.S
PROHIBIT	P.R.OW.HH.IH.B.AH.T
PRONOUNCE	P.R.AH.N.AW.N.S
PROSODIC	P.R.OW.Z.AA.D.IH.K
PROSPEROUS	P.R.AA.S.P.ER.AH.S
PROVE	P.R.UW.V
PSYCHOPATH	S.AY.K.OW.P.AE.TH
PULPIT	P.UH.L.P.IH.T
PUZZLE	P.AH.Z.AH.L
QUARTER	K.W.AO.R.T.ER
QUARTET	K.W.AO.R.T.EH.T
QUEER	K.W.IH.R
QUIVER	K.W.IH.V.ER
RADIATOR	R.EY.D.IY.EY.T.ER
RAG	R.AE.G
RAINSTORM	R.EY.N.S.T.AO.R.M
RAPTURE	R.AE.P.CH.ER
RATIFY	R.AE.T.AH.F.AY
READING	R.IY.D.IH.NG
REBUFF	R.IY.B.AH.F
RECESS	R.IY.S.EH.S
RECLAIM	R.IY.K.L.EY.M
REFORM	R.IH.F.AO.R.M
REGARD	R.IH.G.AA.R.D
REGULAR	R.EY.G.Y.AH.L.ER
REITERATE	R.IY.IH.T.ER.EY.T
REJECTION	R.IY.JH.EH.K.SH.AH.N
RELATIVE	R.EH.L.AH.T.IH.V
REMNANT	R.EH.M.N.AH.N.T
REMOVE	R.IY.M.UW.V
RENDER	R.EH.N.D.ER
RENEW	R.IH.N.UW
REPARATION	R.EH.P.ER.EY.SH.AH.N
REPEAL	R.IY.P.IY.L
REPROBATE	R.EH.P.R.AO.B.EY.T
REQUIRE	R.IY.K.W.AY.ER
RESCUE	R.EH.S.K.Y.UW
RESIDUAL	R.IH.Z.IH.JH.UW.AH.L
RESOUND	R.IY.Z.AW.N.D
RESTOCK	R.IY.S.T.AA.K
RESTRAINT	R.IY.S.T.R.EY.N.T
REUNION	R.IY.UW.N.Y.AH.N
REWARD	R.IY.W.AO.R.D
RIDDLE	R.IH.D.AH.L
RIDGE	R.IH.JH
RIGHTLY	R.AY.T.L.IY
RIGOROUS	R.IH.G.ER.AH.S
RIM	R.IH.M
RINSE	R.IH.N.S
ROADWAY	R.OW.D.W.EY
ROBE	R.OW.B
ROEMER	R.OW.M.ER
ROSE	R.OW.Z
ROUNDING	R.AW.N.D.IH.NG
ROUTINE	R.UW.T.IY.N
RUBBISH	R.AH.B.IH.SH
RUBRIC	R.UW.B.R.IH.K
RUBY	R.UW.B.IY
RUE	R.UW
RUIN	R.UW.IH.N
RUNAWAY	R.AH.N.AH.W.EY
RUSH	R.AH.SH
RUT	R.AH.T
SADDLE	S.AE.D.AH.L
SAINTED	S.EY.N.T.IH.D
SANDWICH	S.AE.N.W.IH.CH
SAP	S.AE.P
SARCASM	S.AA.R.K.AE.Z.AH.M
SCAMPER	S.K.AE.M.P.ER
SCANTY	S.K.AE.N.T.IY
SCHOOLMATE	S.K.UW.L.M.EY.T
SCHOOLROOM	S.K.UW.L.R.UW.M
SCOURGE	S.K.ER.JH
SCOUT	S.K.AW.T
SCRATCH	S.K.R.AE.CH
SCULPTURE	S.K.AH.L.P.CH.ER
SCURRILOUS	S.K.ER.AH.L.AH.S
SEASHORE	S.IY.SH.AO.R
SECRETE	S.IH.K.R.IY.T
SEE	S.IY
SELF	S.EH.L.F
SERENADE	S.EH.R.AH.N.EY.D
SERPENT	S.ER.P.AH.N.T
SERVANT	S.ER.V.AH.N.T
SERVICE	S.ER.V.IH.S
SERVILE	S.ER.V.AH.L
SHABBY	SH.AE.B.IY
SHALL	SH.AE.L
SHARE	SH.EH.R
SHARECROP	SH.EH.R.K.R.AA.P
SHEEP	SH.IY.P
SHEIK	SH.IY.K
SHIFT	SH.IH.F.T
SHINGLE	SH.IH.NG.G.AH.L
SHIVER	SH.IH.V.ER
SHOCKER	SH.AA.K.ER
SHOPWORN	SH.AA.P.W.AO.R.N
SHOULD	SH.UH.D
SHRIMP	SH.R.IH.M.P
SHRINK	SH.R.IH.NG.K
SIEVE	S.IH.V
SIMPLIFY	S.IH.M.P.L.AH.F.AY
SISTER	S.IH.S.T.ER
SIXTY	S.IH.K.S.T.IY
SIZE	S.AY.Z
SKILL	S.K.IH.L
SKINNY	S.K.IH.N.IY
SKIP	S.K.IH.P
SKIPPER	S.K.IH.P.ER
SLAT	S.L.AE.T
SLATE	S.L.EY.T
SLIT	S.L.IH.T
SLOPE	S.L.OW.P
SMASH	S.M.AE.SH
SMOOTH	S.M.UW.DH
SOB	S.AA.B
SODIUM	S.OW.D.IY.AH.M
SOFA	S.OW.F.AH
SOFTWOOD	S.AO.F.T.W.UH.D
SOIL	S.OY.L
SOMEBODY	S.AH.M.B.AH.D.IY
SOMEWHAT	S.AH.M.W.AH.T
SOOTHE	S.UW.DH
SORE	S.AO.R
SORGHUM	S.AO.R.G.AH.M
SOUTH	S.AW.TH
SOUTHBOUND	S.AW.TH.B.AW.N.D
SPARKLE	S.P.AA.R.K.AH.L
SPEW	S.P.Y.UW
SPINELESS	S.P.AY.N.L.AH.S
SPLICE	S.P.L.AY.S
SPONGE	S.P.AH.N.JH
SPOUSE	S.P.AW.S
SQUABBLE	S.K.W.AA.B.AH.L
SQUAT	S.K.W.AA.T
SQUEAL	S.K.W.IY.L
SQUIRT	S.K.W.ER.T
STAIN	S.T.EY.N
STAND	S.T.AE.N.D
STANDBY	S.T.AE.N.D.B.AY
STARK	S.T.AA.R.K
STARLIGHT	S.T.AA.R.L.AY.T
STARTER	S.T.AA.R.T.ER
STARVE	S.T.AA.R.V
STATIC	S.T.AE.T.IH.K
STATION	S.T.EY.SH.AH.N
STEAL	S.T.IY.L
STICK	S.T.IH.K
STILL	S.T.IH.L
STONEWARE	S.T.OW.N.W.EH.R
STORE	S.T.AO.R
STRADDLE	S.T.R.AE.D.AH.L
STROLL	S.T.R.OW.L
STUBBORN	S.T.AH.B.ER.N
SUBSIDIZE	S.AH.B.S.IH.D.AY.Z
SUCTION	S.AH.K.SH.AH.N
SUFFICE	S.AH.F.AY.S
SUFFRAGETTE	S.AH.F.R.AH.JH.EH.T
SUGAR	SH.UH.G.ER
SUITOR	S.UW.T.ER
SUM	S.AH.M
SUMPTUOUS	S.AH.M.P.CH.W.AH.S
SUNRISE	S.AH.N.R.AY.Z
SURFACE	S.ER.F.AH.S
SURGEON	S.ER.JH.IH.N
SURGERY	S.ER.JH.ER.IY
SWAGGER	S.W.AE.G.ER
SWEAT	S.W.EH.T
SWEET	S.W.IY.T
SWIPE	S.W.AY.P
SWIVEL	S.W.IH.V.AH.L
SYMPATHY	S.IH.M.P.AH.TH.IY
SYSTEMIC	S.IH.S.T.EH.M.IH.K
TAFFY	T.AE.F.IY
TALLY	T.AE.L.IY
TALON	T.AE.L.AH.N
TAP	T.AE.P
TASTE	T.EY.S.T
TASTY	T.EY.S.T.IY
TAXATION	T.AE.K.S.EY.SH.AH.N
TEEM	T.IY.M
TEETOTALER	T.IY.T.OW.T.EY.L.ER
TELLING	T.EH.L.IH.NG
TEMPERA	T.EH.M.P.ER.AH
TEMPO	T.EH.M.P.OW
TEMPTATION	T.EH.M.T.EY.SH.AH.N
TENABLE	T.EH.N.AH.B.AH.L
TEPID	T.EH.P.IH.D
TERRIER	T.EH.R.IY.ER
TERRIFY	T.EH.R.AH.F.AY
TEXTURE	T.EH.K.S.CH.ER
THAT	DH.AH.T
THE	DH.IY
THEATRE	TH.IY.AH.T.ER
THEN	DH.EH.N
THIEF	TH.IY.F
THING	TH.IH.NG
THIRST	TH.ER.S.T
THIRTIETH	TH.ER.T.IY.IH.TH
THOROUGHFARE	TH.ER.OW.F.EH.R
THREAT	TH.R.EH.T
THREE	TH.R.IY
THROAT	TH.R.OW.T
THUNDER	TH.AH.N.D.ER
THYROID	TH.AY.R.OY.D
TICKLE	T.IH.K.AH.L
TIMELY	T.AY.M.L.IY
TIMIDLY	T.IH.M.AH.D.L.IY
TODAY	T.UW.D.EY
TOE	T.OW
TOILET	T.OY.L.AH.T
TOKEN	T.OW.K.AH.N
TOLERATION	T.AA.L.ER.EY.SH.AH.N
TOT	T.AA.T
TOUR	T.UH.R
TOW	T.OW
TRANSIT	T.R.AE.N.Z.IH.T
TRAPDOOR	T.R.AE.P.D.AO.R
TRENCH	T.R.EH.N.CH
TROPIC	T.R.AA.P.IH.K
TRUCK	T.R.AH.K
TSUNAMI	T.S.UW.N.AA.M.IY
TUITION	T.Y.UW.IH.SH.AH.N
TWENTY	T.W.EH.N.T.IY
TWIG	T.W.IH.G
TWINKLE	T.W.IH.NG.K.AH.L
TWITCH	T.W.IH.CH
UNABLE	AH.N.EY.B.AH.L
UNDERDOG	AH.N.D.ER.D.AO.G
UNDERNEATH	AH.N.D.ER.N.IY.TH
UNDOING	AH.N.D.UW.IH.NG
UNHEALTHY	AH.N.HH.EH.L.TH.IY
UNIQUE	Y.UW.N.IY.K
UNKNOWN	AH.N.N.OW.N
UNTIL	AH.N.T.IH.L
UNWORTHY	AH.N.W.ER.DH.IY
UPGRADE	AH.P.G.R.EY.D
UPHOLSTER	AH.P.OW.L.S.T.ER
UPSTREAM	AH.P.S.T.R.IY.M
USELESS	Y.UW.S.L.AH.S
USUAL	Y.UW.ZH.UW.AH.L
UTILIZE	Y.UW.T.AH.L.AY.Z
VALVE	V.AE.L.V
VAUDEVILLE	V.AA.D.V.IH.L
VECTOR	V.EH.K.T.ER
VENEER	V.AH.N.IH.R
VENERATE	V.EH.N.ER.EY.T
VENEREAL	V.AH.N.IH.R.IY.AH.L
VENTURE	V.EH.N.CH.ER
VERB	V.ER.B
VERBAL	V.ER.B.AH.L
VERSATILE	V.ER.S.AH.T.AH.L
VERTEBRAL	V.ER.T.AH.B.R.AH.L
VERTICAL	V.ER.T.IH.K.AH.L
VERTIGO	V.ER.T.IH.G.OW
VICTIMIZE	V.IH.K.T.AH.M.AY.Z
VIGNETTE	V.IY.N.Y.EH.T
VIRGINITY	V.ER.JH.IH.N.IH.T.IY
WALLOW	W.AA.L.OW
WALNUT	W.AO.L.N.AH.T
WANDERING	W.AA.N.D.ER.IH.NG
WANGLE	W.AE.NG.G.AH.L
WANTON	W.AO.N.T.AH.N
WARILY	W.EH.R.AH.L.IY
WARP	W.AO.R.P
WARRIOR	W.AO.R.Y.ER
WARSHIP	W.AO.R.SH.IH.P
WASHING	W.AA.SH.IH.NG
WAYWARD	W.EY.W.ER.D
WEAVE	W.IY.V
WEDLOCK	W.EH.D.L.AA.K
WELCOME	W.EH.L.K.AH.M
WEST	W.EH.S.T
WET	W.EH.T
WHEAT	W.IY.T
WHEEZE	W.IY.Z
WHETHER	W.EH.DH.ER
WHIMSICAL	W.IH.M.Z.IH.K.AH.L
WHIRL	W.ER.L
WHOOSH	W.UW.SH
WHORE	HH.AO.R
WHORL	W.ER.L
WIDE	W.AY.D
WIDEN	W.AY.D.AH.N
WIDESPREAD	W.AY.D.S.P.R.EH.D
WIPE	W.AY.P
WITH	W.IH.TH
WITHIN	W.IH.TH.IH.N
WITNESS	W.IH.T.N.AH.S
WONDERFULLY	W.AH.N.D.ER.F.L.IY
WOOD	W.UH.D
WOODWIND	W.UH.D.W.IH.N.D
WORST	W.ER.S.T
WORSTED	W.ER.S.T.IH.D
WORTHWHILE	W.ER.TH.W.AY.L
WORTHY	W.ER.DH.IY
WOW	W.AW
WRESTLE	R.EH.S.AH.L
YACHT	Y.AA.T
YELP	Y.EH.L.P
YOUNGSTER	Y.AH.NG.S.T.ER
YOUTHFUL	Y.UW.TH.F.AH.L
ZEALOUSLY	Z.IY.L.AH.S.L.IY